.--.--.--.Y .--.--.
|     |        |  |
:  :--:  :  :  :  :
|  |     |  |     |
:  :  :  :--:--:--:
|  |  |           |
:  :  :--:--:--:  :
|  |        |  |  |
:  :--:--:  :  :  :
|     |     |  |  |
:--:  :  :--:  :  :
|        |        |
: X:--:--:--:--:--:
